ExceptionNullReference={0} is null
ExceptionDICOMTag=Tag: {0} - {1}
ExceptionDICOMFile=File: {0} - {1}
ExceptionDecodingBadModuleNumber=The module number provided from the OFFIS toolkit is unexpected and cannot be dealt with in this version of the software.
ExceptionOffisAssociationBadPresentationContextID=Bad presentation context ID
ExceptionOffisAssociationMissingTransferSyntax=Missing transfer syntax
ExceptionOffisAssociationNullKey=User passed in a NULL key
ExceptionOffisAssociationShutdownApplication=Application shutdown requested
ExceptionOffisDimseBadCommandType=Bad command type
ExceptionOffisDimseBadData=Inappropriate data for message
ExceptionOffisDimseBadMessage=Badly formed message
ExceptionOffisDimseIllegalAssociation=Caller passed in an illegal association
ExceptionOffisDimseNoDataAvailable=No data available (timeout occurred in non-blocking mode)
ExceptionOffisDimseNoDataDictionary=Data dictionary missing
ExceptionOffisDimseNoValidPresentationContextID=No valid Presentation Context ID
ExceptionOffisDimseNullKey=Caller passed in a NULL key
ExceptionOffisDimseOutOfResources=Out of resources
ExceptionOffisDimseParseFailed=Failed to parse received message
ExceptionOffisDimseReadPDVFailed=Read PDV failed
ExceptionOffisDimseReceiveFailed=Failed to receive message
ExceptionOffisDimseSendFailed=Failed to send message
ExceptionOffisDimseUnexpectedPDVType=Unexpected PDV type
ExceptionOffisDulAssociationRejected=Association rejected
ExceptionOffisDulIllegalAccept=Attempt to accept by requestor
ExceptionOffisDulIllegalKey=Illegal key
ExceptionOffisDulIllegalPdu=Illegal or ill-formed PDU
ExceptionOffisDulIllegalPduLength=Illegal PDU length
ExceptionOffisDulIllegalRequest=Attempt to request by acceptor
ExceptionOffisDulIncorrectBufferLength=Incorrect buffer space allocated for data
ExceptionOffisDulInsufficientBufferLength=Insufficient buffer space allocated for data
ExceptionOffisDulListError=List error
ExceptionOffisDulNetworkClosed=Network closed
ExceptionOffisDulNoAssociationRequest=No requests for associations for this server
ExceptionOffisDulNoPdvs=No PDVs available in current buffer
ExceptionOffisDulNullKey=NULL key passed to routine
ExceptionOffisDulPCTranslationFailure=Presentation Context translation failure
ExceptionOffisDulPDataPduArrived=P-Data PDU arrived
ExceptionOffisDulPeerAbortedAssociation=Peer aborted association (or never connected)
ExceptionOffisDulPeerRequestedRelease=Peer requested release
ExceptionOffisDulReadTimeout=Network read timeout
ExceptionOffisDulRequestAssociationFailed=Failed to establish association
ExceptionOffisDulUnexpectedPdu=Received unexpected PDU
ExceptionOffisDulUnsupportedPeerProtocol=Unsupported peer protocol
ExceptionOffisDulWrongDataType=Wrong data type specified for request
ExceptionOffisFormatNetwork=- {0} - {1} @ {2} {3} (Error 0x{4:x4})
ExceptionOffisModuleAssociation=Association
ExceptionOffisModuleDimse=DIMSE
ExceptionOffisModuleDul=DICOM Upper Layer
ExceptionOffisUnknownError=An unknown error occurred in the OFFIS DICOM subsystem
ExceptionDicomSaveDirectoryDoesNotExist=The specified directory where incoming DICOM objects should be saved does not exist - {0}
ExceptionDicomNullDataset=The passed in dataset is null
ExceptionDicomConnectionTimeoutOutOfRange=The connection timeout value must be between 1 and 32767
